R  1024 758

NO ./textures/test.xpm
SO ./textures/doors.xpm
WE ./textures/brick.xpm
EA ./textures/east.xpm

S ./textures/chest.xpm
F 202, 252, 175
C 0, 255, 255

11111
10001
1110111111111111111111111111111111111111111111
  10000000000000000010000020000000200000000001
1110000110000020000000002020202000000000000011        111111111
100011111200000000001000202020000000000000001         100000001
11111 111111111111111002000200000000000011111         100000001
      100000000010100000000022000000020001            100000001
111111100000000110000020200020000000000001111         111111111
1000000000000200W0000000000200000020020000001
100000000000001110000000202000000000020000021
100220100000001010000000000000000002000000021
111111111000001110000000000002000200000000001
      100000000000000011111100111111111111111
11111 11100000000000001    1001
10001 1000000000000000111  1001
11111 1111111111111111111  11111